7ma_gmx_su,7ma_mp_su,gmx_s_total,gmx_stake,gmx_total,gmx_u_total,gmx_unstake,mp_b_rate,mp_b_total,mp_boost,mp_burn,mp_s_rate,mp_s_total,mp_sb_rate,mp_stake,mp_total,mp_u_total,mp_unstake,time_scale
-6030.125,-5038.875,47519628,27232,8482549,39037079,-28589,87.31265278494696,7172001,96.83598644699842,-6390,0.07163240063500102,17466502,84.55006861734604,12275,8214160,9252342,-6391,2023-08-19 00:00:00.000 UTC
-6753.5,-1452.75,47524529,4901,8474803,39049726,-12647,87.00853426344015,7176912,97.32987303657677,-4911,0.4164992122824533,17505768,84.6852959295927,39266,8248515,9257253,-4911,2023-08-20 00:00:00.000 UTC
-7513.75,-2.625,47532466,7937,8469507,39062959,-13233,86.88878403474705,7181749,97.59068621113366,-4837,0.2048890260058436,17527540,84.79536058001959,21772,8265450,9262090,-4837,2023-08-21 00:00:00.000 UTC
-10163.0,762.375,47540427,7961,8454028,39086399,-23440,86.88033203789126,7189940,97.89040206632862,-8191,0.12363935685300619,17545963,85.04750634845307,18423,8275682,9270281,-8191,2023-08-22 00:00:00.000 UTC
-11991.25,2938.75,47552648,12221,8447330,39105318,-18919,86.7113958409002,7195518,98.23503994753372,-5578,0.27181673989104677,17574200,85.18097434337241,28237,8298238,9275962,-5681,2023-08-23 00:00:00.000 UTC
-3405.625,14062.25,47564115,11467,8447780,39116335,-11017,86.67303976396185,7199750,98.33107633011277,-4232,0.10298800030288464,17586987,85.22653288793032,12787,8306793,9280194,-4232,2023-08-24 00:00:00.000 UTC
-3331.625,16279.0,47573598,9483,8450088,39123510,-7175,86.5240636058278,7202822,98.51549474987716,-3072,0.214459569812338,17607912,85.23960933897966,20925,8324646,9283266,-3072,2023-08-25 00:00:00.000 UTC
-4217.375,15920.375,47578426,4828,8450167,39128259,-4749,86.4344173254144,7204861,98.6446658391485,-2039,0.13187951157673694,17620984,85.26294214067012,13072,8335639,9285345,-2079,2023-08-26 00:00:00.000 UTC
-4135.5,16437.875,47584011,5585,8449465,39134546,-6287,86.3711966323107,7208249,98.77149618348618,-3388,0.12011028961989,17634396,85.3101231853141,13412,8345663,9288733,-3388,2023-08-27 00:00:00.000 UTC
-2974.875,14204.25,47587585,3574,8451004,39136581,-2035,86.21505070048381,7209431,98.9485864638095,-1182,0.19715027799672072,17652064,85.30857398718543,17668,8362149,9289915,-1182,2023-08-28 00:00:00.000 UTC
-2208.625,13965.75,47601533,13948,8451838,39149695,-13114,86.1161923779565,7214105,99.1166181841157,-4674,0.179380258932127,17671961,85.35545759395767,19897,8377176,9294785,-4870,2023-08-29 00:00:00.000 UTC
-612.125,13484.375,47635578,34045,8449131,39186447,-36752,86.17948205039937,7224906,99.22389651669504,-10801,0.07611327745490369,17698152,85.51064008831204,26191,8383557,9314595,-19810,2023-08-30 00:00:00.000 UTC
-9312.875,2541.875,47652360,16782,8372827,39279533,-93086,87.93718586108459,7315119,99.35202291890182,-90213,-0.781191677947648,17726102,87.36737305094205,27950,8318573,9407529,-92934,2023-08-31 00:00:00.000 UTC
-9707.75,4859.0,47694707,42347,8370118,39324589,-45056,87.9598689858747,7340836,99.70785358103673,-25717,0.32462362196421735,17780251,87.70289737850769,54149,8345665,9434586,-27057,2023-09-01 00:00:00.000 UTC
-11732.0,1979.75,47714452,19745,8356232,39358220,-33631,88.30573861181198,7365126,99.8115418528351,-24290,-0.062118697188316654,17800117,88.13931925298388,19866,8340484,9459633,-25047,2023-09-02 00:00:00.000 UTC
-10864.0,908.375,47727665,13213,8363255,39364410,-6190,88.32446392180374,7368827,99.75668564452477,-3701,0.029030651909538473,17806333,88.10955782168546,6216,8342906,9463427,-3794,2023-09-03 00:00:00.000 UTC
-11308.125,-1233.75,47751421,23756,8359000,39392421,-28011,88.68570752656646,7392657,99.72237109702118,-23830,-0.08533081375701149,17825207,88.43949036966144,18874,8335793,9489414,-25987,2023-09-04 00:00:00.000 UTC
-4856.75,-2042.875,47826611,75190,8412150,39414461,-22040,88.66636727477251,7399923,99.2113312292339,-7266,0.11997642887936767,17846513,87.9670833259036,21306,8345806,9500707,-11293,2023-09-05 00:00:00.000 UTC
-4104.5,-2747.75,47851339,24728,8419002,39432337,-17876,88.72381658642516,7413047,99.24209544076602,-13124,0.11236124499323416,17871156,88.05137473539025,24643,8355194,9515962,-15255,2023-09-06 00:00:00.000 UTC
-4520.25,-2912.0,47866854,15515,8412969,39453885,-21548,88.7578988263644,7420392,99.37349109452323,-7345,0.0606081556544706,17883771,88.20182268590315,12615,8360261,9523510,-7548,2023-09-07 00:00:00.000 UTC
4980.25,7267.125,47870942,4088,8412669,39458273,-4388,88.624734531815,7423837,99.57256133576632,-3445,0.1963658763404726,17903665,88.24591815035157,19894,8376710,9526955,-3445,2023-09-08 00:00:00.000 UTC
4728.125,4590.75,47876180,5238,8407943,39468237,-9964,88.59117881759512,7426059,99.69609689314022,-2222,0.06777302562001701,17911629,88.32194747276473,7964,8382391,9529238,-2283,2023-09-09 00:00:00.000 UTC
5601.5,5557.25,47892255,16075,8401044,39491211,-22974,88.6842985914512,7436127,99.8083333452366,-10068,0.03042358551794395,17924450,88.51432036304058,12821,8384942,9539508,-10270,2023-09-10 00:00:00.000 UTC
5022.25,7036.25,47906500,14245,8403433,39503067,-11856,88.59166996460137,7440988,99.94958012993023,-4861,0.16970671954791863,17943567,88.54700215971259,19117,8399196,9544371,-4863,2023-09-11 00:00:00.000 UTC
6163.875,10450.875,47918301,11801,8408311,39509990,-6923,88.42588545502055,7444929,100.1318814206563,-3941,0.23996959403282894,17967712,88.54250276898654,24145,8419400,9548312,-3941,2023-09-12 00:00:00.000 UTC
-259.0,10259.625,47923244,4943,8410078,39513166,-3176,88.36602264174763,7447385,100.21171028378095,-2456,0.10065398392455138,17978651,88.55310259904843,10939,8427883,9550768,-2456,2023-09-13 00:00:00.000 UTC
-936.0,10681.25,47967746,44502,8411514,39556232,-43066,88.30105854482193,7453178,100.34631102082217,-5793,0.15118514653621218,18005710,88.6068548420653,27059,8440644,9565066,-14298,2023-09-14 00:00:00.000 UTC
-1835.75,9558.25,47973637,5891,8398283,39575354,-19122,88.53914557149946,7469806,100.45776023503852,-16628,-0.04642795719240412,18018421,88.94444257236867,12711,8436727,9581694,-16628,2023-09-15 00:00:00.000 UTC
-1749.625,8154.25,47977375,3738,8398672,39578703,-3349,88.50177162985207,7471270,100.51522431165307,-1464,0.061798562037369595,18025105,88.95775427353276,6684,8441944,9583161,-1467,2023-09-16 00:00:00.000 UTC
975.875,9345.125,47996976,19601,8415750,39581226,-2523,88.35221360571502,7472081,100.49195853013696,-811,0.17982412991985955,18041542,88.78686985711315,16437,8457152,9584390,-1229,2023-09-17 00:00:00.000 UTC
1858.875,10813.75,48001905,4929,8415915,39585990,-4764,88.22531249660625,7473965,100.65990447859798,-1884,0.16880223130580213,18057771,88.80751528502843,16229,8471452,9586319,-1929,2023-09-18 00:00:00.000 UTC
1325.75,11669.375,48059088,57183,8414039,39645049,-59059,88.03890609547119,7476749,100.93310715579047,-2784,0.24844125163334313,18087999,88.86040342812768,30228,8492551,9595448,-9129,2023-09-19 00:00:00.000 UTC
1142.875,11254.25,48069487,10399,8417454,39652033,-6984,87.91414329084637,7480996,101.09272946427743,-4247,0.19840332506251296,18109177,88.87480703785255,21178,8509434,9599743,-4295,2023-09-20 00:00:00.000 UTC
-3663.625,10380.5,48074561,5074,8380769,39693792,-41759,88.00746381680867,7490251,101.55305557282392,-9255,0.017542154926249515,18119926,89.37426863811662,10749,8510927,9608999,-9256,2023-09-21 00:00:00.000 UTC
-3720.875,9810.125,48079806,5245,8381747,39698059,-4267,87.95604008627646,7493085,101.6390139191746,-2834,0.09623054010828577,18130977,89.39765182604533,11051,8519125,9611852,-2853,2023-09-22 00:00:00.000 UTC
-2249.75,11257.375,48085809,6003,8380285,39705524,-7465,87.89988396565835,7495035,101.74816250282657,-1950,0.08984627971195712,18140591,89.43651677717405,9614,8526786,9613805,-1953,2023-09-23 00:00:00.000 UTC
-2618.375,11464.75,48087999,2190,8377725,39710274,-4750,87.84272215140464,7496201,101.86132870200441,-1166,0.0805750216026836,18148636,89.47776395143073,8045,8533662,9614974,-1169,2023-09-24 00:00:00.000 UTC
-3417.625,12753.0,48102409,14410,8388409,39714000,-3726,87.60744024892115,7498475,102.0357495682435,-2274,0.2980894422547217,18176712,89.39090833553777,28076,8559176,9617536,-2562,2023-09-25 00:00:00.000 UTC
-3638.375,13344.5,48125053,22644,8386808,39738245,-24245,87.4442657487438,7501151,102.28215549944628,-2676,0.22186451995568307,18227372,89.43987986847917,50660,8578208,9649164,-31628,2023-09-26 00:00:00.000 UTC
-3949.75,12494.375,48128891,3838,8382441,39746450,-8205,87.3531540158366,7505825,102.50601227017286,-4674,0.16640081484959102,18246346,89.54223477385645,18974,8592506,9653840,-4676,2023-09-27 00:00:00.000 UTC
-3796.375,12207.875,48139795,10904,8387083,39752712,-6262,87.2465942930584,7509399,102.62324815433448,-3574,0.16952289488546488,18264511,89.53528896757072,18165,8607097,9657414,-3574,2023-09-28 00:00:00.000 UTC
-5533.25,3362.25,48144110,4315,8336503,39807607,-54895,89.18134302354522,7614147,102.41494545134813,-104748,-0.8113541797823216,18299987,91.3350238103435,35476,8537825,9762162,-104748,2023-09-29 00:00:00.000 UTC
-5766.625,5194.125,48151387,7277,8335614,39815773,-8166,88.98320904021855,7617566,102.70002905604794,-3419,0.2669531548786206,18326260,91.38578153930833,26273,8560678,9765582,-3420,2023-09-30 00:00:00.000 UTC
-6667.875,5728.875,48155563,4176,8326942,39828621,-12848,88.92541215827092,7623235,102.95036281026096,-5669,0.13926902368319966,18343875,91.54903444745982,17615,8572617,9771258,-5676,2023-10-01 00:00:00.000 UTC
-6867.75,6945.0,48160705,5142,8322783,39837922,-9301,88.78566650157605,7625998,103.20132100043939,-2763,0.19332367937398753,18363256,91.62798068867109,19381,8589222,9774034,-2776,2023-10-02 00:00:00.000 UTC
-7854.5,5333.875,48166709,6004,8325573,39841136,-3214,88.68524399469091,7628569,103.31837820652103,-2571,0.14677080399128234,18378453,91.62815580381074,15197,8601847,9776606,-2572,2023-10-03 00:00:00.000 UTC
-10345.875,5318.625,48171995,5286,8304041,39867954,-26818,88.66156417586066,7643298,103.81399850988211,-14729,0.21935428640431462,18412092,92.04311491236616,33639,8620757,9791335,-14729,2023-10-04 00:00:00.000 UTC
-9679.25,4137.0,48221234,49239,8305007,39916227,-48273,88.6556787572624,7647086,103.86026164697995,-3788,0.05616999254081049,18463321,92.07801992219873,51229,8625602,9837719,-46384,2023-10-05 00:00:00.000 UTC
-9971.25,4697.5,48227118,5884,8307313,39919805,-3578,88.47058137626195,7647996,104.06104837990335,-910,0.2206560175701186,18487213,92.0634144879337,23892,8644677,9842536,-4817,2023-10-06 00:00:00.000 UTC
-3555.5,14074.25,48234896,7778,8308059,39926837,-7032,88.44905662951123,7651214,104.12081811166725,-3218,0.06637828757196616,18499270,92.09388137469895,12057,8650419,9848851,-6315,2023-10-07 00:00:00.000 UTC
-3607.75,12628.5,48237325,2429,8306752,39930573,-3736,88.34829997693295,7652470,104.27307809357977,-1256,0.13030920236729346,18511882,92.12349182929742,12612,8661706,9850176,-1325,2023-10-08 00:00:00.000 UTC
-2201.125,12405.875,48244160,6835,8309333,39934827,-4254,88.27827558181262,7655372,104.36293743432836,-2902,0.11713744588245387,18524944,92.12980151355109,13062,8671864,9853080,-2904,2023-10-09 00:00:00.000 UTC
-378.25,11540.625,48260377,16217,8319757,39940620,-5793,88.22373477906645,7659185,104.34856450735279,-3813,0.11153542104880618,18538451,92.06020079673,13507,8681547,9856904,-3824,2023-10-10 00:00:00.000 UTC
-885.375,10877.0,48264176,3799,8318490,39945686,-5066,88.19099806269244,7662795,104.45240662668344,-3610,0.08419973936750988,18549383,92.11761990457403,10932,8688863,9860520,-3616,2023-10-11 00:00:00.000 UTC
1285.5,9404.625,48280391,16215,8314325,39966066,-20380,88.27682033819251,7676547,104.5904989280549,-13752,0.0820032764512027,18578574,92.32916682953818,29191,8695994,9882580,-22060,2023-10-12 00:00:00.000 UTC
405.375,7455.875,48313486,33095,8308250,40005236,-39170,88.61768960222096,7696667,104.53764631540938,-20120,-0.12371550890481091,18587972,92.63884692925707,9398,8685249,9902723,-20143,2023-10-13 00:00:00.000 UTC
474.5,7185.625,48321149,7663,8311109,40010040,-4804,88.47669119467093,7699385,104.70518435024736,-2718,0.19435400076440773,18607604,92.63968262237927,19632,8702162,9905442,-2719,2023-10-14 00:00:00.000 UTC
390.625,7277.0,48324127,2978,8311184,40012943,-2903,88.43391645188942,7701387,104.78212249903262,-2002,0.07432852565298695,18616316,92.66293466731094,8712,8708635,9907681,-2239,2023-10-15 00:00:00.000 UTC
-259.375,8483.25,48461199,137072,8304677,40156522,-143579,88.28830325243895,7707191,105.11633384416999,-5804,0.23983993716988647,18843602,92.8054275921869,227286,8729572,10114030,-206349,2023-10-16 00:00:00.000 UTC
-247.5,8313.0,48468395,7196,8307353,40161042,-4520,88.21611770069651,7708649,105.18835542440534,-1458,0.1006595281864989,18853856,92.7930834286204,10254,8738368,10115488,-1458,2023-10-17 00:00:00.000 UTC
-1619.125,8729.125,48473681,5286,8306804,40166877,-5835,88.1104694345349,7710882,105.35195003999132,-2233,0.14868512166081235,18869101,92.82609773867301,15245,8751380,10117721,-2233,2023-10-18 00:00:00.000 UTC
-1755.375,9607.0,48476649,2968,8304447,40172202,-5325,88.00382490015936,7714168,105.55451795887191,-3286,0.1635804204994479,18887540,92.8920131587329,18439,8765719,10121821,-4100,2023-10-19 00:00:00.000 UTC
-1239.25,10597.625,48485019,8370,8304411,40180608,-8406,87.88067112527084,7716604,105.73627678109862,-2436,0.17146550276029165,18906965,92.92174965810338,19425,8780775,10126190,-4369,2023-10-20 00:00:00.000 UTC
-2228.75,12935.25,48491710,6691,8290420,40201290,-20682,87.8996524071564,7725264,106.010684621527,-8660,0.09052501436214169,18923587,93.18302329676904,16622,8788731,10134856,-8666,2023-10-21 00:00:00.000 UTC
-2802.375,12051.75,48496189,4479,8288690,40207499,-6209,87.83885028668276,7728568,106.1515872833946,-3304,0.11189310633902577,18936783,93.24233383079836,13196,8798576,10138207,-3351,2023-10-22 00:00:00.000 UTC
312.5,14729.625,48565092,68903,8313684,40251408,-43909,87.67902962814588,7738965,106.16799964973409,-10397,0.3160492663433363,18975088,93.08707186850017,38305,8826472,10148616,-10409,2023-10-23 00:00:00.000 UTC
5096.375,14037.0,48628189,63097,8345448,40282741,-31333,87.71164645298934,7755348,105.94839246497013,-16383,0.17412610095513753,19009820,92.9290794215002,34732,8841868,10167952,-19336,2023-10-24 00:00:00.000 UTC
5224.875,16560.5,48652465,24276,8349152,40303313,-20572,87.4857792690037,7760734,106.2485387737581,-5386,0.32673299024716,19044192,92.95236210815182,34372,8870852,10173340,-5388,2023-10-25 00:00:00.000 UTC
7007.875,16538.625,48724770,72305,8362867,40361903,-58590,87.53814997350763,7776617,106.22779245442979,-15883,0.1445007811507134,19082817,92.98984427230518,38625,8883689,10199128,-25788,2023-10-26 00:00:00.000 UTC
6510.5,14519.0,48745618,20848,8356531,40389087,-27184,87.68230252387139,7787829,106.28657992174024,-11212,-0.020468660263136,19098552,93.19452054925662,15735,8881871,10216681,-17553,2023-10-27 00:00:00.000 UTC
8247.25,14720.75,48768233,22615,8370389,40397844,-8757,87.56945661092082,7792404,106.30976648755512,-4575,0.1873340809465282,19119855,93.09488483749082,21303,8898541,10221314,-4633,2023-10-28 00:00:00.000 UTC
10817.375,15464.25,48779209,10976,8376959,40402250,-4406,87.47857630537973,7796480,106.39236744503584,-4076,0.15600657283158548,19137859,93.07052833850565,18004,8912445,10225414,-4100,2023-10-29 00:00:00.000 UTC
11956.75,17371.625,48796329,17120,8384344,40411985,-9735,87.30058990445815,7802533,106.59807135775918,-6053,0.28088237614137834,19169319,93.060745122099,31460,8937549,10231770,-6356,2023-10-30 00:00:00.000 UTC
10414.125,20923.5,48822788,26459,8396997,40425791,-13806,86.90744574632026,7816334,107.10805303372146,-13801,0.6261049204679637,19240010,93.08487308022141,70691,8993860,10246150,-14380,2023-10-31 00:00:00.000 UTC
5328.25,20676.75,48838793,16005,8388074,40450719,-24928,86.89300501527542,7826698,107.38200449829127,-10364,0.14901276544911105,19264474,93.30745055420351,24464,9007282,10257192,-11042,2023-11-01 00:00:00.000 UTC
4934.125,20015.375,48851416,12623,8388625,40462791,-12072,86.71337258712376,7831063,107.65739319614357,-4365,0.26235262527025044,19295529,93.35335647975681,31055,9030975,10264554,-7362,2023-11-02 00:00:00.000 UTC
3761.125,19345.125,48873527,22111,8392956,40480571,-17780,86.75722054113261,7841508,107.69090175142107,-10445,0.08270223323689349,19313842,93.42963313521481,18313,9038450,10275392,-10838,2023-11-03 00:00:00.000 UTC
4155.5,22837.125,48887980,14453,8389775,40498205,-17634,86.59855604812054,7849785,108.04304048678301,-8277,0.28813287075567195,19348341,93.56371297204036,34499,9064568,10283773,-8381,2023-11-04 00:00:00.000 UTC
2220.625,21793.375,48900801,12821,8388154,40512647,-14442,86.54719423407408,7852330,108.16310716279172,-2545,0.09170178227704343,19362237,93.61213444579106,13896,9072888,10289349,-5576,2023-11-05 00:00:00.000 UTC
2243.375,25135.25,48922857,22056,8394906,40527951,-15304,86.23427570906412,7858984,108.56020305647259,-6654,0.4459195654986264,19409652,93.61610481403841,47415,9113527,10296125,-6776,2023-11-06 00:00:00.000 UTC
102.0,23987.25,49036873,114016,8385160,40651713,-123762,86.17328081317521,7867144,108.87624088270229,-8160,0.17438077027009413,19546039,93.82222879468013,136387,9129447,10416592,-120467,2023-11-07 00:00:00.000 UTC
-590.75,19720.25,49063884,27011,8392271,40671613,-19900,86.05763000263778,7875669,109.04821829514324,-8525,0.24230677359707384,19578559,93.84431222490312,32520,9151622,10426937,-10345,2023-11-08 00:00:00.000 UTC
2658.75,22165.875,49099392,35508,8409344,40690048,-18435,85.82224893841426,7882438,109.21909009787207,-6769,0.3591551910375281,19618373,93.73427939206674,39814,9184609,10433764,-6827,2023-11-09 00:00:00.000 UTC
-85.0,22805.375,49141082,41690,8387945,40753137,-63089,85.75130315372644,7900626,109.8411827926864,-18188,0.31268525969406796,19680343,94.19024564419533,61970,9213418,10466925,-33161,2023-11-10 00:00:00.000 UTC
-674.25,23882.5,49172453,31371,8387562,40784891,-31754,85.70254542223802,7909925,110.03805396609884,-9299,0.17435378476213798,19717216,94.30541318204266,36873,9229510,10487706,-20781,2023-11-11 00:00:00.000 UTC
-1956.25,21525.0,49276716,104263,8374125,40902591,-117700,85.8081744610236,7925902,110.30129117967549,-15977,0.07857726858572175,19850151,94.64752436821757,132935,9236768,10613383,-125677,2023-11-12 00:00:00.000 UTC
-1201.875,20700.875,49321818,45102,8378539,40943279,-40688,86.00092331056086,7945191,110.2637942008744,-19289,0.018693520968512727,19886890,94.82788109000865,36739,9238495,10648395,-35012,2023-11-13 00:00:00.000 UTC
-2835.125,15421.375,49346159,24341,8372225,40973934,-30655,86.23914651866893,7965822,110.3278758036245,-20631,-0.01728935406670075,19905924,95.1458184652228,19034,9236898,10669026,-20631,2023-11-14 00:00:00.000 UTC
-717.625,18508.625,49413665,67506,8379419,41034246,-60312,85.94506331220555,7973567,110.71789106142084,-7745,0.43781115548601585,19997815,95.15656157067691,91891,9277516,10720299,-51273,2023-11-15 00:00:00.000 UTC
-2695.625,16761.125,49440868,27203,8370706,41070162,-35916,86.06820737798108,7992045,110.9310373581392,-18478,0.08825387738214123,20033485,95.4763552799489,35670,9285711,10747774,-27475,2023-11-16 00:00:00.000 UTC
-6323.875,13899.125,49457848,16980,8358753,41099095,-28933,86.0085660172194,7995186,111.21039226784187,-3141,0.10855437755666482,20046722,95.65046365169542,13237,9295802,10750920,-3146,2023-11-17 00:00:00.000 UTC
-3941.875,11162.625,49461185,3337,8356410,41104775,-5680,85.97692782078013,7998192,111.32434861381861,-3006,0.0743546053578529,20056738,95.71325485465648,10016,9302719,10754019,-3099,2023-11-18 00:00:00.000 UTC
-5281.375,10703.875,49470547,9362,8345311,41125236,-20461,85.92155502530773,8003714,111.62125653555633,-5522,0.133352785534862,20074738,95.90671935413792,18000,9315141,10759597,-5578,2023-11-19 00:00:00.000 UTC
-7143.75,10048.125,49482275,11728,8316975,41165300,-40064,86.03228904795273,8015760,112.02574253259148,-12046,0.021594579374192954,20090030,96.37831062375443,15292,9317153,10772877,-13280,2023-11-20 00:00:00.000 UTC
-5194.75,10728.75,49525734,43459,8336981,41188753,-23453,86.05339260482661,8023898,111.8429441065057,-8138,0.07691709587557276,20105580,96.24464779276815,15550,9324325,10781255,-8378,2023-11-21 00:00:00.000 UTC
-6412.375,13273.125,49540612,14878,8320926,41219686,-30933,85.97412652761408,8032634,112.28417366047962,-8736,0.20076884685708132,20133114,96.53533753334665,27534,9343083,10790031,-8776,2023-11-22 00:00:00.000 UTC
-7021.625,16097.0,49552911,12299,8323246,41229665,-9979,85.44646498322612,8037344,113.01230313269606,-4710,0.6719863682734919,20202342,96.5650180230165,69228,9406292,10796050,-6019,2023-11-23 00:00:00.000 UTC
-5477.0,16051.75,49564198,11287,8326890,41237308,-7643,85.4101363642399,8040617,113.05691560714746,-3273,0.08320475880658054,20214329,96.56206578926826,11987,9414125,10800204,-4154,2023-11-24 00:00:00.000 UTC
-4944.125,15501.75,49572338,8140,8319200,41253138,-15830,85.40796338272425,8045273,113.2298297913261,-4656,0.06041519282329931,20227421,96.70729156649678,13092,9419816,10807605,-7401,2023-11-25 00:00:00.000 UTC
-4800.625,15700.5,49576140,3802,8318005,41258135,-4997,85.36245523196438,8048248,113.34836898992006,-2975,0.09022813495040423,20238961,96.75695073518229,11540,9428323,10810638,-3033,2023-11-26 00:00:00.000 UTC
-3263.75,13797.75,49604799,28659,8319201,41285598,-27463,85.59093219548666,8067393,113.29841651860558,-19145,-0.02970657437258389,20257434,96.97317086099976,18473,9425523,10831911,-21273,2023-11-27 00:00:00.000 UTC
-456.875,15992.25,49609023,4224,8313320,41295703,-10105,85.49550237260817,8075128,113.61394725572936,-7735,0.20717640518233227,20284737,97.13481497163589,27303,9445091,10839646,-7735,2023-11-28 00:00:00.000 UTC
-5451.125,15956.625,49612482,3459,8293372,41319110,-23407,85.55242087952384,8086396,113.9702644473201,-11268,0.07286305575404428,20303037,97.50432031747762,18300,9451978,10851059,-11413,2023-11-29 00:00:00.000 UTC
-4394.875,13737.75,49624858,12376,8285767,41339091,-19981,85.77017735667623,8107842,114.08702417048416,-21446,0.010652719749370172,20325785,97.85264297197833,22748,9452985,10872800,-21741,2023-11-30 00:00:00.000 UTC
-4779.375,6207.5,49642057,17199,8285011,41357046,-17955,85.91144498195422,8123745,114.13324617191213,-15903,0.03137706282773009,20344664,98.05352099110067,18879,9455952,10888712,-15912,2023-12-01 00:00:00.000 UTC
-6219.5,5565.75,49647897,5840,8277134,41370763,-13717,86.00268685249091,8134694,114.2744698829329,-10949,0.028534724454893197,20358446,98.27911448576283,13782,9458651,10899795,-11083,2023-12-02 00:00:00.000 UTC
-8028.0,7449.875,49657595,9698,8254976,41402619,-31856,85.93356235590487,8145999,114.83273845980897,-11305,0.21904305276222213,20390954,98.6798629093531,32508,9479415,10911539,-11744,2023-12-03 00:00:00.000 UTC
-10906.375,7205.625,49666680,9085,8230754,41435926,-33307,86.03292779397948,8161056,115.25029177156796,-15057,0.06908098361706469,20413697,99.15320030218375,22743,9485968,10927729,-16190,2023-12-04 00:00:00.000 UTC
-12618.5,7542.5,49680041,13361,8218253,41461788,-25862,86.22532288311564,8179216,115.42432436674801,-18160,-0.0011069103570228666,20444371,99.5249963708832,30674,9485863,10958508,-30779,2023-12-05 00:00:00.000 UTC
-13239.5,5620.25,49691378,11337,8207404,41483974,-22186,86.44697769338063,8203864,115.62795008019589,-24648,0.04415149209387977,20473655,99.95686821314024,29284,9490053,10983602,-25094,2023-12-06 00:00:00.000 UTC
-11041.0,6609.875,49709161,17783,8205044,41504117,-20143,86.40159446901727,8212348,115.84163351226393,-8484,0.15575194871422054,20496945,100.08901841355147,23290,9504857,10992088,-8486,2023-12-07 00:00:00.000 UTC
-7748.625,16512.625,49738141,28980,8223778,41514363,-10246,85.76542766543774,8220690,116.55331649273606,-8342,0.8370190940383841,20587815,99.96245034824626,90870,9585086,11002729,-10641,2023-12-08 00:00:00.000 UTC
-7356.25,17458.875,49759755,21614,8226161,41533594,-19231,85.74935676401626,8228185,116.64764402252763,-7495,0.10981048338393454,20606975,100.02460442969692,19160,9595623,11011352,-8623,2023-12-09 00:00:00.000 UTC
-6886.75,18083.75,49767199,7444,8222040,41545159,-11565,85.752699508847,8235107,116.79973583198331,-6922,0.08015976972965914,20621703,100.15892649512772,14728,9603321,11018382,-7030,2023-12-10 00:00:00.000 UTC
-7255.125,14963.0,49779212,12013,8196935,41582277,-37118,86.01594583836287,8256773,117.1061988413962,-21666,-0.04377485058785082,20640454,100.7300045687809,18751,9599119,11041335,-22953,2023-12-11 00:00:00.000 UTC
-4549.375,15120.0,49795929,16717,8194359,41601570,-19293,86.00923208751018,8262845,117.23830991539424,-6072,0.08128508926058362,20654335,100.83577007060589,13881,9606928,11047407,-6072,2023-12-12 00:00:00.000 UTC
-2958.25,16763.375,49838742,42813,8194587,41644155,-42585,85.95855288530005,8269187,117.39420180663163,-6342,0.13557214835389297,20721997,100.91035704422933,67662,9619970,11102027,-54620,2023-12-13 00:00:00.000 UTC
-2285.75,16575.25,49847139,8397,8189118,41658021,-13866,86.0304354671346,8278412,117.50538946929328,-9225,0.027902902057696133,20733961,101.09039825778552,11964,9622655,11111306,-9279,2023-12-14 00:00:00.000 UTC
-2921.25,15204.125,49854668,7529,8181674,41672994,-14973,86.10193331110301,8288594,117.65917341610042,-10182,0.03983798871655193,20750238,101.30682302912581,16277,9626490,11123748,-12442,2023-12-15 00:00:00.000 UTC
-9654.25,5814.5,49857688,3020,8146544,41711144,-38150,86.36394028739976,8318231,118.22930067032107,-29637,0.05307528280342149,20785010,102.1074826331264,34772,9631602,11153408,-29660,2023-12-16 00:00:00.000 UTC
-10291.0,5445.5,49870878,13190,8143833,41727045,-15901,86.42092948295328,8330275,118.36179597494203,-12044,0.07868920895507059,20805411,102.28936423426167,20401,9639187,11166224,-12816,2023-12-17 00:00:00.000 UTC
-8670.375,4805.5,49894011,23133,8152677,41741334,-14289,86.52325585616326,8342369,118.26501896248311,-12094,0.02673784312312113,20820084,102.32674494524927,14673,9641765,11178319,-12095,2023-12-18 00:00:00.000 UTC
-6877.875,3900.75,49903575,9564,8141912,41761663,-20329,86.93928813409724,8372536,118.2808780050681,-30167,-0.1187914218886694,20839690,102.8325533363662,19606,9630325,11209365,-31046,2023-12-19 00:00:00.000 UTC
-13374.0,1653.375,49930615,27040,8087367,41843248,-81585,87.51120953872365,8418714,118.95286809662527,-46178,-0.10571555240014324,20899567,104.09709365235929,59877,9620155,11279412,-70047,2023-12-20 00:00:00.000 UTC
-20100.875,760.25,49951662,21047,8033780,41917882,-74634,87.68970913516777,8441057,119.81971126916595,-22343,0.06126083673763657,20927871,105.06955629852945,28304,9626052,11301819,-22407,2023-12-21 00:00:00.000 UTC
-20452.25,1188.375,49967336,15674,8025500,41941836,-23954,87.84939455960146,8461796,120.01946296180923,-20739,0.06343331850108003,20955356,105.43637156563454,27485,9632162,11323194,-21375,2023-12-22 00:00:00.000 UTC
-19751.375,2682.875,49976859,9523,8023663,41953196,-11360,87.77647445007246,8468633,120.24374652823779,-6837,0.1636720245216783,20981589,105.54572144916854,26233,9647953,11333636,-10442,2023-12-23 00:00:00.000 UTC
-9130.75,2762.75,50045134,68275,8073498,41971636,-18440,87.77933319687449,8473957,119.57275520474519,-5324,0.05957298877197809,21004321,104.96016720385637,22732,9653704,11350617,-16981,2023-12-24 00:00:00.000 UTC
-8184.5,2414.875,50060167,15033,8078357,41981810,-10174,87.82694756311173,8482771,119.56027692264652,-8814,0.04971783420748509,21017961,105.00614171916394,13640,9658506,11359455,-8838,2023-12-25 00:00:00.000 UTC
-13309.625,299.0,50070369,10202,8046200,42024169,-42359,88.27519087464046,8513398,119.85977231488157,-30627,-0.1487843883089004,21035895,105.80644279287117,17934,9644157,11391738,-32283,2023-12-26 00:00:00.000 UTC
-13684.875,6161.25,50094662,24293,8032433,42062229,-38060,88.09895848130324,8527640,120.50663852409352,-14242,0.3663162222877666,21089759,106.16509344055531,53864,9679615,11410144,-18406,2023-12-27 00:00:00.000 UTC
-6762.25,8449.5,50127528,32866,8033269,42094259,-32030,88.1530398541416,8540047,120.59537655218566,-12407,0.08398234017368944,21130572,106.30849035430035,40813,9687751,11442821,-32677,2023-12-28 00:00:00.000 UTC
9284.125,9252.25,50229546,102018,8108053,42121493,-27234,88.2220437584471,8557600,119.63500978594985,-17553,0.12699908351176847,21160734,105.54445068378315,30162,9700070,11460664,-17843,2023-12-29 00:00:00.000 UTC
8708.0,9467.875,50250150,20604,8095164,42154986,-33493,88.24528052138952,8566768,119.92227705331233,-9168,0.08070742348632377,21180707,105.82574979333342,19973,9707905,11472802,-12138,2023-12-30 00:00:00.000 UTC
9046.375,8727.625,50270304,20154,8096034,42174270,-19284,88.21517149915196,8572551,120.03128939428862,-5783,0.10155617942956895,21209230,105.88580779181511,28523,9717774,11491456,-18654,2023-12-31 00:00:00.000 UTC
1792.0,10621.0,50277931,7627,8087834,42190097,-15827,88.08656868205439,8578462,120.41137342828748,-5911,0.21458777952476477,21237468,106.06624715591344,28238,9738672,11498796,-7340,2024-01-01 00:00:00.000 UTC
363.625,10950.75,50300350,22419,8081266,42219084,-28987,88.23333858671027,8599320,120.6013018257288,-20858,0.07633813360650893,21266502,106.41055497987568,29034,9746112,11520390,-21594,2024-01-02 00:00:00.000 UTC
4351.75,18490.375,50335552,35202,8081014,42254538,-35454,87.99264303396214,8616310,121.17390218603754,-16990,0.4694406091453501,21330037,106.62411920088246,63535,9792080,11537957,-17567,2024-01-03 00:00:00.000 UTC
5173.375,16711.5,50345569,10017,8073820,42271749,-17211,87.8962209171689,8625526,121.54478301473158,-9216,0.2163083250121493,21361553,106.83327099192203,31516,9813307,11548246,-10289,2024-01-04 00:00:00.000 UTC
7068.75,16863.25,50376769,31200,8089819,42286950,-15201,87.85168819393775,8629370,121.41998479817657,-3844,0.09518809421931357,21378163,106.66950645002069,16610,9822657,11555506,-7260,2024-01-05 00:00:00.000 UTC
-1404.75,15817.5,50419145,42376,8096815,42322330,-35380,87.90453676293248,8638036,121.3638943214091,-8666,0.04022750470406376,21407039,106.6843691006896,28876,9826610,11580429,-24923,2024-01-06 00:00:00.000 UTC
1846.625,16388.0,50436327,17182,8109937,42326390,-4060,87.805052317769,8639147,121.32041223008268,-1111,0.12601878908739692,21420560,106.52545143075712,13521,9839009,11581551,-1122,2024-01-07 00:00:00.000 UTC
-953.5,15187.25,50449443,13116,8088406,42361037,-34647,87.93693273242167,8652354,121.64661368383338,-13207,0.002672961983366249,21434743,106.9723008464214,14183,9839272,11595471,-13920,2024-01-08 00:00:00.000 UTC
-1621.75,13976.125,50474525,25082,8074860,42399665,-38628,88.01391525956956,8669794,121.9894957931159,-17440,0.11379139759774166,21463853,107.36773145292922,29110,9850481,11613372,-17901,2024-01-09 00:00:00.000 UTC
-991.875,16569.5,50502841,28316,8073331,42429510,-29845,87.83956501018153,8677379,122.36173643815668,-7585,0.28533199010230936,21505323,107.48201702618164,41470,9878668,11626655,-13283,2024-01-10 00:00:00.000 UTC
-399.0,12627.5,50553874,51033,8077822,42476052,-46542,87.78870121599903,8685024,122.4723694084866,-7645,0.14587945133476868,21579764,107.5169024521709,74441,9893100,11686664,-60009,2024-01-11 00:00:00.000 UTC
800.375,11173.5,50582883,29009,8080223,42502660,-26608,87.78159884758644,8692744,122.5547240466012,-7720,0.09689281554162782,21615592,107.58049623135402,35828,9902695,11712897,-26233,2024-01-12 00:00:00.000 UTC
473.25,10672.25,50610077,27194,8093605,42516472,-13812,87.87891847374378,8707074,122.41806957468273,-14330,0.05389565135771119,21635652,107.5796755586664,20060,9908035,11727617,-14720,2024-01-13 00:00:00.000 UTC
1761.75,12107.625,50636331,26254,8110909,42525422,-8950,87.8093662993523,8713737,122.34721163805438,-6663,0.15555041174605136,21658142,107.43231122430296,22490,9923471,11734671,-7054,2024-01-14 00:00:00.000 UTC
-114.5,7729.0,50646677,10346,8109021,42537656,-12234,88.07916418413345,8720578,122.09662547427118,-6841,-0.2285664419820498,21672974,107.54168721476982,14832,9900841,11772133,-37462,2024-01-15 00:00:00.000 UTC
2755.875,10509.375,50654389,7712,8110453,42543936,-6280,87.91595214800006,8724205,122.35256156468695,-3627,0.22679847837629782,21701175,107.5674194770625,28201,9923347,11777828,-5695,2024-01-16 00:00:00.000 UTC
3908.875,11343.75,50659949,5560,8106131,42553818,-9882,87.82752357328786,8731137,122.63842022784976,-6932,0.17989723807846333,21725813,107.71028743552257,24638,9941231,11784582,-6754,2024-01-17 00:00:00.000 UTC
7505.0,8848.0,50696661,36712,8133371,42563290,-9472,87.7738492532051,8733017,122.32876134631016,-1880,0.08262766632775352,21735622,107.37266257742331,9809,9949452,11786170,-1588,2024-01-18 00:00:00.000 UTC
4074.875,2882.75,50717923,21262,8110421,42607502,-44212,88.65574200986228,8791247,122.2644545825673,-58230,-0.33571456375964814,21753521,108.39445942448612,17899,9916162,11837359,-51189,2024-01-19 00:00:00.000 UTC
409.5,2863.375,50730159,12236,8083499,42646660,-39158,88.61340601809341,8795414,122.78843604731068,-4167,0.09510758138398054,21769095,108.80701537787041,15574,9925602,11843493,-6134,2024-01-20 00:00:00.000 UTC
-1645.25,3499.5,50740122,9963,8080443,42659679,-13019,88.58145672049534,8801481,122.96393898205828,-6067,0.10496142775722017,21784961,108.92324839120826,15866,9936031,11848930,-5437,2024-01-21 00:00:00.000 UTC
-3192.5,3890.25,50768352,28230,8085369,42682983,-23304,88.57608744023989,8817389,123.11859854510041,-15908,0.18646668929608673,21816665,109.05363750250608,31704,9954593,11862072,-13142,2024-01-22 00:00:00.000 UTC
-6812.625,6139.0,50779448,11096,8054520,42724928,-41945,88.88233944421647,8843751,123.53253825181389,-26362,-0.04663338610745197,21837195,109.79860997303376,20530,9949953,11887242,-25170,2024-01-23 00:00:00.000 UTC
-4861.5,5210.875,50816714,37266,8071561,42745153,-20225,88.76113217476227,8845077,123.45857263545427,-1326,0.15133917255074092,21889829,109.58322683803046,52634,9965034,11924795,-37553,2024-01-24 00:00:00.000 UTC
-4956.125,3221.875,50832477,15763,8066482,42765995,-20842,88.85503831341127,8856187,123.56075424205993,-11110,0.01978527955135173,21904749,109.78995552212227,14920,9967006,11937743,-12948,2024-01-25 00:00:00.000 UTC
-10508.25,2543.75,50889530,57053,8049305,42840225,-74230,88.95381272366292,8868519,123.85916548074647,-12332,0.028044689352907912,22035428,110.17745010283497,130679,9969802,12065626,-127883,2024-01-26 00:00:00.000 UTC
-8201.5,6940.0,50895101,5571,8044809,42850292,-10067,89.00298866329672,8875095,123.95175572223032,-6576,0.018853389027046794,22043487,110.32076709341389,8059,9971682,12071805,-6179,2024-01-27 00:00:00.000 UTC
-4137.875,6638.25,50905068,9967,8050396,42854672,-4380,88.95923199676751,8876982,123.95300802594058,-1887,0.07040991679483957,22051739,110.26764397676834,8252,9978708,12073031,-1226,2024-01-28 00:00:00.000 UTC
-2896.625,6622.25,50918097,13029,8057270,42860827,-6155,88.90378414915834,8880607,123.97510571198434,-3625,0.10312334286614418,22065446,110.21856038087343,13707,9989009,12076437,-3406,2024-01-29 00:00:00.000 UTC
-2928.5,5314.75,50934004,15907,8061941,42872063,-11236,88.91647797048567,8889079,124.0037727887118,-8472,0.08104341344214343,22083805,110.25978731424604,18359,9997111,12086694,-10257,2024-01-30 00:00:00.000 UTC
-968.125,6734.125,50941355,7351,8046775,42894580,-22517,88.9698001544609,8900384,124.32093602716617,-11305,0.06712431823584296,22104100,110.60808833352492,20295,10003826,12100274,-13580,2024-01-31 00:00:00.000 UTC
-4022.875,-36741.875,50950774,9419,8039378,42911396,-16816,92.31659194058504,8928029,120.29660752361688,-27645,-3.4404259536584205,22117377,111.05372828594452,13277,9671099,12446278,-346004,2024-02-01 00:00:00.000 UTC
-4127.75,-36523.0,50956349,5575,8033460,42922889,-11493,92.38188568223788,8937783,120.43156995864797,-9754,0.03848132813192842,22129704,111.25695528452249,12327,9674822,12454882,-8604,2024-02-02 00:00:00.000 UTC
-2371.75,-36755.0,50963613,7264,8030331,42933282,-10393,92.446155661952,8944870,120.49020146243036,-7087,0.009714997123740745,22139371,111.38855920135795,9667,9675762,12463609,-8727,2024-02-03 00:00:00.000 UTC
-2802.0,-35929.75,50968766,5153,8022393,42946373,-13091,92.43935819874014,8952053,120.71515319680799,-7183,0.08758556682380163,22153896,111.58831286375523,14525,9684244,12469652,-6043,2024-02-04 00:00:00.000 UTC
-3231.125,-36154.875,50975193,6427,8024547,42950646,-4273,92.43404359929322,8956368,120.74786277655298,-4315,0.05392452362456601,22163099,111.61213212409373,9203,9689469,12473630,-3978,2024-02-05 00:00:00.000 UTC
-4228.5,-36594.625,50982993,7800,8023442,42959551,-8905,92.45014465383119,8964199,120.84903212361976,-7831,0.06995486503444837,22176180,111.7251050110414,13081,9696252,12479928,-6298,2024-02-06 00:00:00.000 UTC
-5129.375,-37161.75,50987365,4372,8020906,42966459,-6908,92.47417760561875,8969826,120.93168776694303,-5627,0.036753270706034964,22184493,111.83058372707522,8313,9699817,12484676,-4748,2024-02-07 00:00:00.000 UTC
-4145.625,-38819.375,51012593,25228,8013610,42998983,-32524,92.73655920689724,8989206,120.96010412286098,-19380,-0.06753138336893706,22194242,112.17423857662152,9749,9693271,12500971,-16295,2024-02-08 00:00:00.000 UTC
-4258.5,2585.0,51018354,5761,8005310,43013044,-14061,92.83519568492018,8997382,121.06687935882559,-8176,-0.015394490526455463,22212042,112.39267436239196,17800,9691779,12520263,-19292,2024-02-09 00:00:00.000 UTC
-17334.75,-1369.25,51029226,10872,7894782,43134444,-121400,93.6790630832292,9053021,122.40829449122216,-55639,-0.28881810057836055,22223588,114.67094341553698,11546,9663868,12559720,-39457,2024-02-10 00:00:00.000 UTC
-19947.125,-783.75,51035876,6650,7870754,43165122,-30678,93.7640157311263,9066504,122.8534394544665,-13483,0.05816231090526782,22241576,115.1923182963157,17988,9669492,12572084,-12364,2024-02-11 00:00:00.000 UTC
-19175.375,-1929.625,51054845,18969,7868990,43185855,-20733,93.9561312993423,9084437,122.87227458670044,-17933,-0.007084638259921829,22257182,115.44603564116869,15606,9668807,12588375,-16291,2024-02-12 00:00:00.000 UTC
-29446.875,-9182.625,51077047,22202,7788972,43288075,-102220,95.20485007915967,9154906,123.45670263033428,-70469,-0.5490740024342742,22280794,117.53676865188372,23612,9616008,12664786,-76411,2024-02-13 00:00:00.000 UTC
-25742.125,-9861.5,51123090,46043,7817505,43305585,-17510,95.35482710431968,9170617,123.02339429268034,-15711,0.01405791194257052,22297503,117.30874492565081,16709,9617360,12680143,-15357,2024-02-14 00:00:00.000 UTC
-29349.125,-15650.875,51137831,14741,7786113,43351718,-46133,96.48885959845884,9238432,122.97034476638086,-67815,-0.4464933819758716,22314204,118.65268330937401,16701,9574610,12739594,-59451,2024-02-15 00:00:00.000 UTC
-29135.375,-15162.25,51151056,13225,7780527,43370529,-18811,96.68417368080749,9254583,123.02473855562741,-16151,-0.027549179254893426,22330843,118.94545189548214,16639,9571973,12758870,-19276,2024-02-16 00:00:00.000 UTC
-27657.375,-16461.375,51175034,23978,7784051,43390983,-20454,97.01441032760368,9274663,122.81635873146257,-20080,-0.12431893932357108,22345606,119.14956620916281,14763,9560088,12785518,-26648,2024-02-17 00:00:00.000 UTC
-13853.25,-12527.625,51184200,9166,7783956,43400244,-9261,97.04329321230698,9280878,122.86357990718344,-6215,0.037213836938983634,22354069,119.23086410046511,8463,9563647,12790422,-4904,2024-02-18 00:00:00.000 UTC
-12847.5,-12283.875,51197226,13026,7767974,43429252,-29008,97.41071698166827,9323395,123.21386503095917,-42517,0.07913305940798984,22388816,120.02350934748236,34747,9571221,12817595,-27173,2024-02-19 00:00:00.000 UTC
-19451.5,-13910.5,51234089,36863,7713378,43520711,-91459,97.95822620568111,9362380,123.90839655466127,-38985,-0.14332165352884843,22448254,121.37846738484748,59438,9557523,12890731,-73136,2024-02-20 00:00:00.000 UTC
-10479.25,-6685.75,51248690,14601,7705138,43543552,-22841,98.10493507884217,9381306,124.10578499697216,-18926,0.05227700391172956,22475077,121.75389980036697,26823,9562522,12912555,-21824,2024-02-21 00:00:00.000 UTC
-16499.375,-6389.25,51279248,30558,7685510,43593738,-50186,98.18213957700857,9392345,124.47119319342504,-11039,0.03892854103898227,22512841,122.20848063433655,37764,9566246,12946595,-34040,2024-02-22 00:00:00.000 UTC
-13334.75,-5345.5,51305578,26330,7679435,43626143,-32405,98.99960616233204,9436490,124.12170947472048,-44145,-0.3608954655792802,22533124,122.88000354192722,20283,9531846,13001278,-54683,2024-02-23 00:00:00.000 UTC
-14235.0,-4895.25,51317025,11447,7666647,43650378,-24235,99.20000511916159,9456549,124.34133200602557,-20059,0.010122932259959838,22545318,123.34660771521109,12194,9532811,13012507,-11229,2024-02-24 00:00:00.000 UTC
-17270.25,-2511.5,51329380,12355,7645889,43683491,-33113,99.19644620396068,9463337,124.77288121760597,-6788,0.07531449698721047,22569127,123.77026399415425,23809,9539996,13029131,-16624,2024-02-25 00:00:00.000 UTC
-17137.0,-2604.625,51344169,14789,7646860,43697309,-13818,99.29936779627803,9475950,124.79383694745295,-12613,0.02948816962718528,22581884,123.91949113753881,12757,9542810,13039074,-9943,2024-02-26 00:00:00.000 UTC
-16513.875,-4714.25,51359927,15758,7635863,43724064,-26755,99.65299233534941,9500425,124.85172926753663,-24475,-0.09758213845125409,22595303,124.41848419752948,13419,9533507,13061796,-22722,2024-02-27 00:00:00.000 UTC
-11261.25,-6461.125,51399407,39480,7623288,43776119,-52055,100.55802573451209,9558879,124.69467243005906,-58454,-0.2911159609982669,22618359,125.39050079178433,23056,9505834,13112525,-50729,2024-02-28 00:00:00.000 UTC
-12188.375,-5708.875,51414605,15198,7607631,43806974,-30855,100.6630029197683,9579948,125.09611730642563,-21069,0.115763081716841,22647841,125.925508216684,29482,9516851,13130990,-18465,2024-02-29 00:00:00.000 UTC
-13209.5,-7342.625,51433111,18506,7579834,43853277,-46303,101.13040171948371,9614978,125.43157277586818,-35030,-0.09830128934983469,22664509,126.84945343130205,16668,9507505,13157004,-26014,2024-03-01 00:00:00.000 UTC
-11723.75,-2350.75,51448876,15765,7585645,43863231,-9954,101.1377856079655,9621278,125.40845241241844,-6300,0.05818329366848032,22674188,126.83533173513919,9679,9513040,13161148,-4144,2024-03-02 00:00:00.000 UTC
-9185.25,-1787.5,51470634,21758,7593165,43877469,-14238,101.14940246431401,9627917,125.3563039918137,-6639,0.057477477307112425,22688698,126.79715243906855,14510,9518511,13170187,-9039,2024-03-03 00:00:00.000 UTC
-14422.125,-7490.875,51484076,13442,7530512,43953564,-76095,102.19373930717171,9688037,125.88877090960085,-60120,-0.40550337766528916,22701858,128.6504423603601,13160,9480069,13221789,-51602,2024-03-04 00:00:00.000 UTC
-25009.875,-17277.25,51522536,38460,7446781,44075755,-122191,104.10180473538884,9790350,126.2907019825076,-102313,-0.8025547519764812,22725300,131.4708999767819,23442,9404592,13320708,-98919,2024-03-05 00:00:00.000 UTC
-26079.75,-17225.25,51548729,26193,7427225,44121504,-45749,104.50300429824053,9818794,126.50357300337609,-28444,-0.0945857708389099,22743576,132.20003433314596,18276,9395705,13347871,-27163,2024-03-06 00:00:00.000 UTC
-23153.625,-12373.25,51572553,23824,7438059,44134494,-12990,104.48034240587283,9828307,126.4691231946399,-9513,0.1184562565484209,22762947,132.1353729514649,19371,9406848,13356099,-8228,2024-03-07 00:00:00.000 UTC
-24617.375,-14728.375,51583688,11135,7410692,44172996,-38502,104.79053995393564,9849288,126.83058478209593,-20981,-0.08324268562352857,22774106,132.90645461989246,11159,9399024,13375082,-18983,2024-03-08 00:00:00.000 UTC
-24832.75,-20449.625,51611111,27423,7381172,44229939,-56943,106.49136314270218,9950455,126.59111588241001,-101167,-0.5898602597542699,22784050,134.80860492073617,9944,9343908,13440142,-65060,2024-03-09 00:00:00.000 UTC
-24735.25,-22710.5,51643541,32430,7387763,44255778,-25839,106.89631817712237,9974876,126.30827491352929,-24421,-0.13451421208235972,22789983,135.01889543560074,5933,9331356,13458627,-18485,2024-03-10 00:00:00.000 UTC
-28124.625,-26007.125,51664666,21125,7368168,44296498,-40720,107.58271293752162,10016439,126.36050100920609,-41563,-0.2245003304887173,22802515,135.94205506714832,12532,9310454,13492061,-33434,2024-03-11 00:00:00.000 UTC
-21849.0,-20143.5,51710927,46261,7355720,44355207,-58709,107.73671114928433,10039899,126.68944712414284,-23460,0.09085815836404236,22888497,136.49104370476311,85982,9318921,13569576,-77515,2024-03-12 00:00:00.000 UTC
-11913.0,-11410.875,51736466,25539,7351477,44384989,-29782,108.03991708636194,10062087,126.68617476460852,-22188,-0.06030082768684157,22905127,136.87163817556663,16630,9313305,13591822,-22246,2024-03-13 00:00:00.000 UTC
-10627.0,-11327.375,51749568,13102,7342209,44407359,-22370,108.40151289305655,10086854,126.73414772039312,-24767,-0.08832803909603845,22919537,137.3817334810273,14410,9305086,13614451,-22629,2024-03-14 00:00:00.000 UTC
-11865.625,-12510.125,51776157,26589,7343134,44433023,-25664,108.47871231760718,10095861,126.74107540458883,-9007,0.018062126192693984,22929285,137.4870865763855,9748,9306767,13622518,-8067,2024-03-15 00:00:00.000 UTC
-8522.125,-11734.125,51791780,15623,7342515,44449265,-16242,108.56779218306076,10102397,126.72975131817911,-6536,-0.017366725161149992,22933993,137.58769304523042,4708,9305151,13628842,-6324,2024-03-16 00:00:00.000 UTC
-8252.125,-5956.625,51798196,6416,7315155,44483041,-33776,108.89718494167812,10123360,127.08213291447686,-20963,-0.0956944490012376,22942501,138.38886530770708,8508,9296255,13646246,-17404,2024-03-17 00:00:00.000 UTC
-9473.75,-7240.5,51816159,17963,7311973,44504186,-21145,109.53339605013548,10157505,126.8253041962819,-34145,-0.24611168766859992,22950334,138.91606273710255,7833,9273432,13676902,-30656,2024-03-18 00:00:00.000 UTC
-5427.125,-4301.875,51843041,26882,7324751,44518290,-14104,109.64253168836397,10170484,126.63964959354932,-12979,0.02810466838270085,22965879,138.8509179356404,15545,9276039,13689840,-12938,2024-03-19 00:00:00.000 UTC
-2679.875,-4440.125,51861130,18089,7334281,44526849,-8559,109.6068358575522,10175241,126.57546118017567,-4757,0.07929206971583687,22977105,138.73535797169484,11226,9283400,13693705,-3865,2024-03-20 00:00:00.000 UTC
-9870.875,-15810.375,51870592,9462,7272510,44598082,-71233,111.96263517460119,10285808,126.32257638696956,-110567,-1.051266694837453,22990743,141.4340853432996,13638,9186822,13803921,-110216,2024-03-21 00:00:00.000 UTC
-10314.375,-14536.375,51881598,11006,7259694,44621904,-23822,112.11070657251577,10301623,126.57275912731308,-15815,0.021471803430155968,23010958,141.90161458595912,20215,9188795,13822163,-18242,2024-03-22 00:00:00.000 UTC
-9670.5,-13253.5,51893230,11632,7265770,44627460,-5556,112.00701378443623,10305473,126.63129991728337,-3850,0.12981565937257866,23026317,141.83593755376236,15359,9200739,13825578,-3415,2024-03-23 00:00:00.000 UTC
-10945.375,-14557.875,51905135,11905,7254952,44650183,-22723,112.38839538354115,10327019,126.65401507825275,-21546,-0.13115038839059506,23037955,142.34441523527656,11638,9188688,13849267,-23689,2024-03-24 00:00:00.000 UTC
-13873.125,-24475.5,51918730,13595,7204170,44714560,-64377,114.59523269780804,10428683,126.32199129115497,-101664,-0.9695893093649974,23047512,144.7589798686039,9557,9100451,13947061,-97794,2024-03-25 00:00:00.000 UTC
-14758.25,-23806.625,51928125,9395,7193907,44734218,-19658,115.10666269293368,10455114,126.25933307172306,-26431,-0.19235979737484804,23055300,145.3329046372159,7788,9082979,13972321,-25260,2024-03-26 00:00:00.000 UTC
-18316.25,-24933.375,51935785,7660,7178221,44757564,-23346,115.40346950368487,10474679,126.445981532193,-19565,-0.0705883234331199,23066592,145.92304973613938,11292,9076572,13990020,-17699,2024-03-27 00:00:00.000 UTC
-20728.25,-27580.5,51964203,28418,7168455,44795748,-38184,115.89427101424776,10503215,126.42551288945805,-28536,-0.15244810739691103,23099672,146.51992653926123,33080,9062756,14036916,-46896,2024-03-28 00:00:00.000 UTC
-13443.75,-15289.875,51978967,14764,7164960,44814007,-18259,115.94459177739806,10509801,126.51156461445703,-6586,0.019272981651613993,23118813,146.68331714343137,19141,9064503,14054310,-17394,2024-03-29 00:00:00.000 UTC
-11974.125,-15972.625,51988573,9606,7163901,44824672,-10665,116.0967083816447,10519539,126.48156360619724,-9738,-0.03850562420497308,23125630,146.84093205643128,6817,9061014,14064616,-10306,2024-03-30 00:00:00.000 UTC
-13820.5,-16827.0,51996759,8186,7155206,44841553,-16881,116.16537741656494,10531696,126.70666644678015,-12157,0.05635264379272154,23143903,147.1892772898502,18273,9066123,14077780,-13164,2024-03-31 00:00:00.000 UTC
-12347.5,-14726.75,52011860,15101,7156172,44855688,-14135,116.25439841849858,10545290,126.75595276357248,-13594,0.05237643031972442,23162338,147.35937034492744,18435,9070874,14091464,-13684,2024-04-01 00:00:00.000 UTC
-5421.75,-3307.375,52041431,29571,7160796,44880635,-24947,116.27353209039637,10550651,126.71764423955103,-5361,0.03436194345333344,23180811,147.33908073906866,18473,9073992,14106819,-15355,2024-04-02 00:00:00.000 UTC
-2950.75,-757.5,52063002,21571,7170301,44892701,-12066,116.31288105578557,10557626,126.59048762388079,-6975,0.03224662465314497,23191889,147.2410432979034,11078,9076919,14114970,-8151,2024-04-03 00:00:00.000 UTC
-1410.0,-156.875,52073759,10757,7166941,44906818,-14117,116.48931932625604,10571775,126.62748305029999,-14149,-0.017652275948046775,23204786,147.50749308526468,12897,9075317,14129469,-14499,2024-04-04 00:00:00.000 UTC
-1629.5,1208.75,52078084,4325,7155419,44922665,-15847,116.66279780072055,10584146,126.79098177199685,-12371,-0.031865787607416145,23214172,147.91790669421317,9386,9072426,14141746,-12277,2024-04-05 00:00:00.000 UTC
-1653.25,-1055.625,52088163,10079,7151734,44936429,-13764,117.1586909006104,10609959,126.62744447710163,-25813,-0.180740891897998,23218262,148.35505627026956,4090,9056058,14162204,-20458,2024-04-06 00:00:00.000 UTC
-2500.125,-895.625,52096053,7890,7143900,44952153,-15724,117.31941851471126,10621923,126.73538263413542,-11964,-0.024398463018325135,23235460,148.685213958762,17198,9053849,14181611,-19407,2024-04-07 00:00:00.000 UTC
-44195.375,-58667.125,52114826,18773,6801643,45313183,-361030,130.02846645246257,11178269,126.39278480214267,-556346,-5.3166729984903665,23252468,164.3465997847873,17008,8596786,14655682,-474071,2024-04-08 00:00:00.000 UTC
-43278.375,-61541.0,52167220,52394,6809945,45357275,-44092,131.1943072870391,11254564,125.9708558586009,-76295,-0.21262344457906968,23299059,165.26659172724595,46591,8578546,14720513,-64831,2024-04-09 00:00:00.000 UTC
-45377.375,-63510.0,52174660,7440,6797777,45376883,-19608,131.62412828896677,11274807,126.01048842879077,-20243,-0.14749159225544226,23305487,165.8602069470652,6428,8565912,14739575,-19062,2024-04-10 00:00:00.000 UTC
-47267.0,-64057.375,52188184,13524,6792165,45396019,-19136,131.8558554771696,11292742,126.0932265338077,-17935,-0.016953783425925278,23315505,166.26130254491756,10018,8564460,14751045,-11470,2024-04-11 00:00:00.000 UTC
-44289.125,-67664.875,52306431,118247,6812628,45493803,-97784,132.8405396860885,11336609,125.26734176590884,-43867,-0.3569487595380266,23327380,166.40581285225028,11875,8533998,14793382,-42337,2024-04-12 00:00:00.000 UTC
-22950.625,-68129.125,52494294,187863,6971814,45522480,-28677,133.1601815466931,11355092,122.3123996136443,-18483,-0.07745626359662326,23339554,162.87141337964553,12174,8527393,14812161,-18779,2024-04-13 00:00:00.000 UTC
-15619.25,-66812.5,52562227,67933,7026780,45535447,-12967,133.40609780511969,11368278,121.27258858253708,-13186,-0.06847339418449068,23346605,161.78502813521982,7051,8521558,14825047,-12886,2024-04-14 00:00:00.000 UTC
-8406.625,-65335.0,52628401,66174,7076647,45551754,-16307,133.32144750619756,11373878,120.55383008365403,-5600,0.11265747988347201,23360819,160.7241112916894,14214,8531169,14829650,-4603,2024-04-15 00:00:00.000 UTC
37186.5,-7499.0,52731565,103164,7099135,45632430,-80676,133.2735333662731,11377287,120.25118553175844,-3409,0.06589124676078631,23374355,160.26300387300708,13536,8536794,14837561,-7911,2024-04-16 00:00:00.000 UTC
37527.25,-6312.875,52882048,150483,7110163,45771885,-139455,133.70296092550188,11402246,119.94159627564093,-24959,-0.10261439816848952,23388458,160.36546560184343,14103,8528043,14860415,-22854,2024-04-17 00:00:00.000 UTC
39644.125,-3266.5,52894658,12610,7114930,45779728,-7843,133.5553492010333,11405333,120.02619843062405,-3087,0.137439137776383,23402678,160.30140844674509,14220,8539780,14862898,-2483,2024-04-18 00:00:00.000 UTC
38426.625,-10299.75,52921420,26762,7099578,45821842,-42114,135.47062023361772,11490702,119.47276302901383,-85369,-0.6804713287877405,23411229,161.85049308564535,8551,8482062,14929167,-66269,2024-04-19 00:00:00.000 UTC
34480.75,-7520.375,52937448,16028,7088474,45848974,-27132,135.81479932049655,11508722,119.54385386756022,-18020,-0.09708709220795543,23417082,162.35824523021458,5853,8473835,14943247,-14080,2024-04-20 00:00:00.000 UTC
15155.875,-4303.375,52952566,15118,7093061,45859505,-10531,135.5390566734872,11511286,119.73626055098075,-2564,0.2252569950238821,23438240,162.2893980469081,21158,8492966,14945274,-2027,2024-04-21 00:00:00.000 UTC
9471.25,-3022.375,52991233,38667,7102550,45888683,-29178,135.89242047459575,11547294,119.63842563586317,-36008,0.051933660955925345,23444850,162.57955241427376,6610,8497379,14947471,-2197,2024-04-22 00:00:00.000 UTC
1934.25,-3454.25,52998212,6979,7092121,45906091,-17408,135.81853899584112,11549377,119.90115509873563,-2083,0.07239342226497568,23452748,162.8479970942402,7898,8503535,14949213,-1742,2024-04-23 00:00:00.000 UTC
-3358.75,-6015.125,53034580,36368,7072265,45962315,-56224,136.35736704665146,11574931,120.02764319493117,-25554,-0.1750803688633076,23486057,163.6665339887575,33309,8488673,14997384,-48171,2024-04-24 00:00:00.000 UTC
-5310.625,-5129.0,53040544,5964,7067678,45972866,-10551,136.49650035801767,11584473,120.08202694010679,-9542,-0.019582866099737587,23492617,163.90776433221774,6560,8487011,15005606,-8222,2024-04-25 00:00:00.000 UTC
-7066.5,-7927.25,53047454,6910,7058398,45989056,-16190,136.85182393106854,11600056,120.08903436728843,-15583,-0.12563172738493236,23495536,164.34403387284198,2919,8476362,15019174,-13568,2024-04-26 00:00:00.000 UTC
-5316.125,-585.625,53051772,4318,7057049,45994723,-5667,136.87002477299288,11602988,120.12637293576962,-2932,0.011973043076885693,23499200,164.41699639608566,3664,8477377,15021823,-2649,2024-04-27 00:00:00.000 UTC
-2692.75,1147.5,53067445,15673,7066932,46000513,-5790,136.79283839531112,11604157,120.03815800123732,-1169,0.06646221891626974,23508166,164.20360348734076,8966,8483015,15025151,-3328,2024-04-28 00:00:00.000 UTC
-4138.375,-1080.0,53077464,10019,7059954,46017510,-16997,136.88247009839085,11613555,120.1753722474679,-9398,0.015452022942069883,23518144,164.49901798227015,9978,8484326,15033818,-8667,2024-04-29 00:00:00.000 UTC
-5959.625,-555.125,53082766,5302,7054873,46027893,-10383,136.79602983090186,11618002,120.38399557298905,-4447,0.10140189413840063,23531166,164.6805264956577,13022,8492938,15038228,-4410,2024-04-30 00:00:00.000 UTC
-5201.5,-1449.75,53099134,16368,7050509,46048625,-20732,136.88362266465236,11624071,120.4443111837741,-6069,-0.011787652216449557,23535746,164.86853644183702,4580,8491937,15043809,-5581,2024-05-01 00:00:00.000 UTC
-5723.5,1123.0,53110350,11216,7026477,46083873,-35248,136.88264894664493,11631818,120.93766193214609,-7747,0.06731267218716877,23548859,165.54267522685976,13113,8497657,15051202,-7393,2024-05-02 00:00:00.000 UTC
-4807.625,1895.125,53123582,13232,7029217,46094365,-10492,136.84618471609375,11634898,120.95475214380207,-3080,0.053104077405161876,23565243,165.5219635416007,16384,8502172,15063071,-11869,2024-05-03 00:00:00.000 UTC
-3804.375,2559.875,53137871,14289,7027963,46109908,-15543,137.0927148101277,11648550,120.90047998260663,-13652,-0.0627409645537677,23583193,165.74575022663038,17950,8496841,15086352,-23281,2024-05-04 00:00:00.000 UTC
-4167.0,3142.875,53149183,11312,7023713,46125470,-15562,137.0069696983953,11649045,121.05449069459415,-495,0.06679196285336583,23589255,165.85308938448938,6062,8502520,15086735,-383,2024-05-05 00:00:00.000 UTC
-5170.25,2603.625,53161243,12060,7025570,46135673,-10203,137.1169555791475,11660212,121.04133899455844,-11167,0.015569429542686815,23601040,165.96819902157404,11785,8503844,15097196,-10461,2024-05-06 00:00:00.000 UTC
-3616.125,3826.625,53176331,15088,7031025,46145306,-9633,136.9756377585324,11663392,121.10523003402776,-3180,0.1303004049706052,23617114,165.88466119804724,16074,8514939,15102175,-4979,2024-05-07 00:00:00.000 UTC
-1583.375,4201.375,53204848,28517,7042206,46162642,-17336,136.81395603309144,11665509,121.07781283308098,-2117,0.13616294235803958,23633238,165.6513456152802,16124,8526549,15106689,-4514,2024-05-08 00:00:00.000 UTC
-38.875,4921.875,53226408,21560,7050198,46176210,-13568,136.77974735890564,11669107,121.0081192045954,-3598,0.055829630893817976,23641366,165.51459973180894,8128,8531312,15110054,-3365,2024-05-09 00:00:00.000 UTC
5104.75,6240.625,53261091,34683,7067315,46193776,-17566,136.5903714056209,11675174,120.94525290014666,-6067,0.19034622891011752,23662431,165.19957013377783,21065,8547582,15114849,-4795,2024-05-10 00:00:00.000 UTC
5121.5,6337.75,53272505,11414,7070189,46202316,-8540,136.53907446783384,11678015,120.97093868353448,-2841,0.06187393851470278,23669874,165.1726000535488,7443,8552874,15117000,-2151,2024-05-11 00:00:00.000 UTC
7816.0,11038.0,53296781,24276,7090491,46206290,-3974,136.06396863419312,11681289,121.07969673750378,-3274,0.375893476464288,23705557,164.74584059129333,35683,8585145,15120412,-3412,2024-05-12 00:00:00.000 UTC
10728.5,13819.125,53325306,28525,7109541,46215765,-9475,135.64166935540894,11682916,121.14808818178275,-1627,0.32425128638756456,23734817,164.327289201933,29260,8613073,15121744,-1332,2024-05-13 00:00:00.000 UTC
9645.0,6632.0,53374206,48900,7102730,46271476,-55711,137.4613352966612,11762429,120.47339544090794,-79513,-0.6564643737802242,23742880,165.60433805029896,8063,8556900,15185980,-64236,2024-05-14 00:00:00.000 UTC
11092.625,7015.625,53402697,28491,7119766,46282931,-11455,137.24549250828136,11763399,120.3840688022612,-970,0.1652536954571801,23757714,165.22170812917165,14834,8571064,15186650,-670,2024-05-15 00:00:00.000 UTC
10691.5,6338.125,53419598,16901,7127738,46291860,-8929,137.19222958769788,11767326,120.33626937465995,-3927,0.07216761914710698,23774265,165.09201095775404,16551,8577254,15197011,-10361,2024-05-16 00:00:00.000 UTC
9858.75,8917.0,53436296,16698,7129068,46307228,-15368,136.7981928355083,11768267,120.6700230661287,-941,0.29518817926759294,23800080,165.0744108486551,25815,8602648,15197432,-421,2024-05-17 00:00:00.000 UTC
8095.5,7057.75,53444463,8167,7132079,46312384,-5156,136.83528350157206,11773368,120.63865248828567,-5101,0.01622492864983024,23805889,165.076242144822,5809,8604044,15201845,-4413,2024-05-18 00:00:00.000 UTC
11105.75,6969.0,53475668,31205,7159035,46316633,-4249,136.78194406401207,11775046,120.24841336856153,-1678,0.053225683169416345,23811421,164.47811751164787,5532,8608626,15202795,-950,2024-05-19 00:00:00.000 UTC
23713.0,6645.75,53611151,135483,7280195,46330956,-14323,136.34113196433887,11777571,118.65493987455007,-2525,0.3436435664332993,23842744,161.77548815656723,31323,8638311,15204433,-1638,2024-05-20 00:00:00.000 UTC
18647.75,1926.375,53624264,13113,7258723,46365541,-34585,136.8268052649805,11806079,118.87055064644292,-28508,-0.11389022683474873,23859020,162.64677685041846,16276,8628484,15230536,-26103,2024-05-21 00:00:00.000 UTC
16526.625,8554.5,53633743,9479,7234943,46398800,-33259,137.0201926046707,11818452,119.21774642868645,-12373,-0.03649712892344136,23866976,163.35238577553412,7956,8625336,15241640,-11104,2024-05-22 00:00:00.000 UTC
13769.125,8572.75,53641919,8176,7229919,46412000,-13200,136.83457632407624,11822023,119.49851720330477,-3571,0.16563178630235542,23883833,163.51528972869545,16857,8639646,15244187,-2547,2024-05-23 00:00:00.000 UTC
13549.625,8780.875,53656876,14957,7236135,46420741,-8741,136.75819175967717,11826166,119.50441775892793,-4143,0.09083549108580617,23893493,163.43208080004035,9660,8647501,15245992,-1805,2024-05-24 00:00:00.000 UTC
13997.125,3438.375,53675119,18243,7241045,46434074,-13333,137.3908695730262,11857045,119.18383327268371,-30879,-0.20099291380050532,23899011,163.74770492380588,5518,8630155,15268856,-22864,2024-05-25 00:00:00.000 UTC
13480.125,3485.375,53681115,5996,7239920,46441195,-7121,137.4203697505783,11862026,119.22682847324279,-4981,0.02052844052087095,23904362,163.841948529818,5351,8631927,15272435,-3579,2024-05-26 00:00:00.000 UTC
8041.0,2708.5,53686012,4897,7223363,46462649,-21454,137.58008707466976,11873566,119.4775065298532,-11540,-0.018921719236911282,23910839,164.3772575184163,6477,8630294,15280545,-8110,2024-05-27 00:00:00.000 UTC
-6438.375,-4.875,53707888,21876,7228688,46479200,-16551,137.49355195113097,11877067,119.4998594489069,-3501,0.09235643424981292,23921337,164.30460133291132,10498,8638272,15283065,-2520,2024-05-28 00:00:00.000 UTC
-2825.125,2794.625,53718850,10962,7236122,46482728,-3528,137.30900845362896,11878384,119.55078977385953,-1317,0.1452922322812314,23935370,164.15400403696898,14033,8650841,15284529,-1464,2024-05-29 00:00:00.000 UTC
-1089.875,2295.75,53729069,10219,7226224,46502845,-20117,137.62075555126728,11895528,119.61574952561669,-17144,-0.08259192646854323,23944200,164.6160982554651,8830,8643702,15300498,-15969,2024-05-30 00:00:00.000 UTC
-6305.5,-182.375,53756538,27469,7179475,46577063,-74218,137.85957632081823,11908568,120.31780875342557,-13040,-0.06384441550061373,23949124,165.86962138596485,4924,8638187,15310937,-10439,2024-05-31 00:00:00.000 UTC
-7997.75,-538.125,53758534,1996,7172153,46586381,-9318,137.8099027257973,11911180,120.5104799074978,-2612,0.057953099756155015,23956307,166.07537513491414,7183,8643196,15313111,-2174,2024-06-01 00:00:00.000 UTC
-8600.375,2001.375,53799985,41451,7172242,46627743,-41362,137.83736051331886,11917647,120.55039414453668,-6467,0.0343504855215595,23966048,166.16348137723182,9741,8646166,15319882,-6771,2024-06-02 00:00:00.000 UTC
-8534.75,2510.5,53808117,8132,7171642,46636475,-8732,137.79220807740535,11921797,120.64198129242926,-4150,0.06755654841400456,23974472,166.2352498911686,8424,8652011,15322461,-2579,2024-06-03 00:00:00.000 UTC
-7019.25,3414.125,53820049,11932,7167209,46652840,-16365,137.86924031086187,11936177,120.79467753765796,-14380,0.06463679859804215,23994502,166.53870425712435,20030,8657607,15336895,-14434,2024-06-04 00:00:00.000 UTC
-11446.375,4439.5,53830681,10632,7137117,46693564,-40724,137.72040543301264,11945576,121.53069649831998,-9399,0.18655055899452463,24016279,167.3725679430504,21777,8673788,15342491,-5596,2024-06-05 00:00:00.000 UTC
-17271.25,3943.5,53838475,7794,7097952,46740523,-46959,137.74146723902834,11959250,122.32245301179833,-13674,0.09906259671157328,24035066,168.48874154122205,18787,8682389,15352677,-10186,2024-06-06 00:00:00.000 UTC
-16497.75,3606.75,53846845,8370,7094242,46752603,-12080,138.10907649371188,11977587,122.24781731437974,-18337,-0.11338064579807844,24038788,168.8353315266099,3722,8672556,15366232,-13555,2024-06-07 00:00:00.000 UTC
-11819.5,4834.625,53851358,4513,7084919,46766439,-13836,138.06754375774472,11979933,122.46948765398729,-2346,0.0496492742078244,24045235,169.0906134565547,6447,8676864,15368371,-2139,2024-06-08 00:00:00.000 UTC
-12765.25,3712.75,53856148,4790,7070031,46786117,-19678,138.23497059460402,11988978,122.67128673127459,-9045,-0.045728659555318185,24049335,169.5746171409998,4100,8672898,15376437,-8066,2024-06-09 00:00:00.000 UTC
-14498.375,4492.75,53872572,16424,7056255,46816317,-30200,138.15276197900326,11994572,123.04130165363922,-5594,0.10608022844221703,24066697,169.98495660941958,17362,8682108,15384589,-8152,2024-06-10 00:00:00.000 UTC
-14674.875,4571.375,53875335,2763,7054243,46821092,-4775,138.07866461984247,11997078,123.16816985181826,-2506,0.07451158313289787,24075164,170.06896416809002,8467,8688582,15386582,-1993,2024-06-11 00:00:00.000 UTC
-14184.0,4884.0,53892801,17466,7053737,46839064,-17972,137.98399366010864,12000025,123.2917955404348,-2947,0.09310450575443799,24091980,170.1229433419477,16816,8696679,15395301,-8719,2024-06-12 00:00:00.000 UTC
-11940.625,2279.25,53899484,6683,7041592,46857892,-18828,138.2100045305914,12013244,123.43830770087219,-13219,-0.05357786715220003,24099095,170.6040906658608,7115,8692022,15407073,-11772,2024-06-13 00:00:00.000 UTC
-6736.375,1891.875,53907670,8186,7044061,46863609,-5717,138.1870403576926,12018851,123.47314993439153,-5607,0.06325938278526164,24110074,170.62389153075193,10979,8697524,15412550,-5477,2024-06-14 00:00:00.000 UTC
-6147.375,3290.875,53911845,4175,7045063,46866782,-3173,138.177901691516,12019934,123.47487879100585,-1083,0.015622695465613227,24112319,170.6149966295546,2245,8698883,15413436,-886,2024-06-15 00:00:00.000 UTC
-5009.125,3524.875,53915000,3155,7044846,46870154,-3372,138.09642733200207,12021381,123.56640585188094,-1447,0.07099316799889903,24119724,170.64079186400951,7405,8705063,15414661,-1225,2024-06-16 00:00:00.000 UTC
-3301.875,4308.0,53918133,3133,7043616,46874517,-4363,138.1026882768857,12025101,123.62062327077456,-3720,0.026402945002171725,24125628,170.723404001581,5904,8707362,15418266,-3605,2024-06-17 00:00:00.000 UTC
-454.625,4444.875,53932860,14727,7052618,46880242,-5725,137.96624716222817,12027438,123.60894918737976,-2337,0.11820823162894385,24137174,170.53862835049338,11546,8717667,15419507,-1241,2024-06-18 00:00:00.000 UTC
-4688.125,-138.125,53939094,6234,7016738,46922356,-42114,138.94809735899156,12071084,123.81076505920556,-43646,-0.3475117113979122,24147842,172.03270237537726,10668,8687477,15460365,-40858,2024-06-19 00:00:00.000 UTC
-4239.375,-549.5,53946572,7478,7019822,46926750,-4394,138.9029326357644,12073836,123.82483487473044,-2752,0.05529042255066937,24155637,171.99632697239332,7795,8692283,15463354,-2989,2024-06-20 00:00:00.000 UTC
-2531.875,309.625,53950452,3880,7021337,46929115,-2365,138.88268892779217,12075154,123.82967802286089,-1318,0.02548738000889988,24158790,171.97798652877648,3153,8694499,15464291,-937,2024-06-21 00:00:00.000 UTC
-324.125,1481.0,53971796,21344,7041468,46930328,-1213,138.65008866310913,12075552,123.68687892922327,-398,0.1707700624109293,24173921,171.4919673000005,15131,8709372,15464549,-258,2024-06-22 00:00:00.000 UTC
202.625,3195.375,53979093,7297,7046684,46932409,-2081,138.41905835625553,12076296,123.80924133961449,-744,0.17277887902567107,24189893,171.37558602031822,15972,8724446,15465447,-898,2024-06-23 00:00:00.000 UTC
5649.875,2898.875,54032717,53624,7090045,46942672,-10263,138.3971868829665,12079658,123.1057630804882,-3362,0.0436284278619756,24200927,170.37491299420526,11034,8728254,15472673,-7226,2024-06-24 00:00:00.000 UTC
6124.875,3818.0,54037425,4708,7092615,46944810,-2138,138.25112103517708,12080253,123.19724107399036,-595,0.11046124780925773,24211001,170.3215668692013,10074,8737906,15473095,-422,2024-06-25 00:00:00.000 UTC
3436.375,1358.875,54038816,1391,7080109,46958707,-13897,138.56397256906027,12094609,123.28253703438747,-14356,-0.10732610661716774,24215340,170.8251807987702,4339,8728538,15486802,-13707,2024-06-26 00:00:00.000 UTC
7606.0,6898.75,54041408,2592,7077586,46963822,-5115,138.3845913380894,12098504,123.52611469503867,-3895,0.16160972389775338,24231811,170.94110901654886,16471,8742667,15489144,-2342,2024-06-27 00:00:00.000 UTC
7548.75,7495.125,54046702,5294,7080212,46966490,-2668,138.26881426066277,12101624,123.61556405373173,-3120,0.10942336616757943,24242881,170.9217746587249,11070,8752244,15490637,-1493,2024-06-28 00:00:00.000 UTC
8703.125,8482.625,54059552,12850,7090962,46968590,-2100,138.12387302051044,12102911,123.57082156130579,-1287,0.11544834953140477,24253983,170.68080466373956,11102,8762360,15491623,-986,2024-06-29 00:00:00.000 UTC
5658.5,6987.5,54067973,8421,7086736,46981237,-12647,138.1570474937914,12109841,123.6856008182046,-6930,0.033222015243793916,24275495,170.88037426538818,21512,8765272,15510223,-18600,2024-06-30 00:00:00.000 UTC
4985.125,6432.25,54075956,7983,7086565,46989391,-8154,138.0475561264116,12114921,123.83861574683928,-5080,0.1211499123053306,24290689,170.95618257928913,15194,8775904,15514785,-4562,2024-07-01 00:00:00.000 UTC
1802.375,6529.5,54095606,19650,7104464,46991142,-1751,137.98631967008674,12115875,123.59116746879147,-954,0.0522294313870866,24295877,170.53890342747883,5188,8780490,15515387,-602,2024-07-02 00:00:00.000 UTC
1910.25,5590.25,54112889,17283,7107897,47004992,-13850,138.19436505793027,12137097,123.56155414182281,-21222,0.024343510848916748,24318818,170.7551052020028,22941,8782628,15536190,-20803,2024-07-03 00:00:00.000 UTC
4367.25,8413.0,54129589,16700,7115047,47014542,-9550,138.0408720393113,12141857,123.62310466817716,-4760,0.15023007461934856,24335446,170.65041172602233,16628,8795842,15539604,-3414,2024-07-04 00:00:00.000 UTC
4949.375,7317.0,54157616,28027,7117181,47040435,-25893,138.06995475504883,12151817,123.66136255351662,-9960,0.060912127580740945,24349656,170.7391873271173,14210,8801203,15548453,-8849,2024-07-05 00:00:00.000 UTC
6583.625,6507.875,54176363,18747,7132881,47043482,-3047,138.02620694621396,12152251,123.43269150291447,-434,0.0352554721229053,24352994,170.36946221309455,3338,8804307,15548687,-234,2024-07-06 00:00:00.000 UTC
4163.25,5844.625,54183894,7531,7124268,47059626,-16144,137.97642828446936,12154505,123.6494331768541,-2254,0.05460252145589621,24359583,170.60707149141498,6589,8809117,15550466,-1779,2024-07-07 00:00:00.000 UTC
4524.375,5836.75,54184983,1089,7122931,47062052,-2426,137.93953585386055,12155185,123.71264020387113,-680,0.032331037137456047,24362769,170.6486416897763,3186,8811966,15550803,-337,2024-07-08 00:00:00.000 UTC
4846.0,6174.875,54191227,6244,7125333,47065894,-3842,137.75045457362768,12156895,123.85811301731442,-1710,0.1511222900788789,24377423,170.61511370766812,14654,8825303,15552120,-1317,2024-07-09 00:00:00.000 UTC
2618.625,6962.25,54195110,3883,7125413,47069697,-3803,137.59745718402553,12158370,124.0094854852624,-1475,0.12318660490247604,24389480,170.63389869471425,12057,8836188,15553292,-1172,2024-07-10 00:00:00.000 UTC
2286.75,7403.75,54200001,4891,7126191,47073810,-4113,137.58339027837815,12164928,124.07551243013273,-6558,0.06412679325996866,24400798,170.7072965066471,11318,8841858,15558940,-5648,2024-07-11 00:00:00.000 UTC
1760.75,6169.375,54206420,6419,7129133,47077287,-3477,137.5354895996098,12165285,124.07114581815209,-357,0.03774930055260499,24406176,170.6418578528413,5378,8845197,15560979,-2039,2024-07-12 00:00:00.000 UTC
3897.125,6127.0,54227825,21405,7148358,47079467,-2180,137.46376219616712,12165844,123.80771919929023,-559,0.056744358529433,24412571,170.1907487006107,6395,8850219,15562352,-1373,2024-07-13 00:00:00.000 UTC
2400.875,6477.0,54244513,16688,7152088,47092425,-12958,137.38366099928828,12166866,123.82569957192922,-1022,0.06666574075360064,24419300,170.1162793298964,6729,8856123,15563177,-825,2024-07-14 00:00:00.000 UTC
4637.125,9030.875,54260041,15528,7161365,47098676,-6251,137.0741251006039,12174052,124.01775359865053,-7186,0.28420184106855656,24450242,169.99625071477297,30942,8881364,15568878,-5701,2024-07-15 00:00:00.000 UTC
4554.0,13153.875,54262126,2085,7159363,47102763,-4087,136.5471347106047,12176177,124.5529385784741,-2125,0.4018415203791057,24487921,170.07346882676572,37679,8917197,15570724,-1846,2024-07-16 00:00:00.000 UTC
4176.875,11400.875,54297132,35006,7158748,47138384,-35621,136.81130846037294,12198794,124.55404213138945,-22617,-0.007704808271397666,24508058,170.4040147802381,20137,8916510,15591548,-20824,2024-07-17 00:00:00.000 UTC
10671.625,-1104521.75,54416632,119500,7210786,47205846,-67462,87613607.14285715,12265905,0.00019415359157795,-67111,-63689257.14285715,24509600,170.10496497885254,1542,14,24509586,-8918038,2024-07-18 00:00:00.000 UTC
13628.75,-1105230.5,54459990,43358,7235221,47224769,-18923,87752978.57142857,12285417,0.00019349789038925004,-19512,0.0,24509600,169.80016228944493,0,14,24509586,0,2024-07-19 00:00:00.000 UTC
15742.125,-1105647.875,54538343,78353,7255070,47283273,-58504,88310228.57142857,12363432,0.0001929685034052049,-78015,0.0,24509600,170.41092642800137,0,14,24509586,0,2024-07-20 00:00:00.000 UTC
15304.875,-1106275.625,54577423,39080,7270797,47306626,-23353,88451785.71428572,12383250,0.00019255110547028063,-19818,0.0,24509600,170.3148912010609,0,14,24509586,0,2024-07-21 00:00:00.000 UTC
17691.375,-1107013.625,54617070,39647,7293619,47323451,-16825,88610021.42857143,12405403,0.00019194860603494646,-22153,0.0,24509600,170.08570093941017,0,14,24509586,0,2024-07-22 00:00:00.000 UTC
16152.875,-1110168.75,54637724,20654,7290588,47347136,-23685,88746678.57142857,12424535,0.0001920284070365792,-19132,0.0,24509600,170.4188331585875,0,14,24509586,0,2024-07-23 00:00:00.000 UTC
16719.375,-1114647.875,54644500,6776,7293118,47351382,-4246,88756157.14285715,12425862,0.00019196179192493526,-1327,0.0,24509600,170.37790969514,0,14,24509586,0,2024-07-24 00:00:00.000 UTC
15160.25,-1114562.0,54823171,178671,7280030,47543141,-191759,89542621.42857143,12535967,0.00019230689983420397,-110105,0.0,24509600,172.19663929956332,0,14,24509586,0,2024-07-25 00:00:00.000 UTC
8755.75,0.0,54846641,23470,7280832,47565809,-22668,89702892.85714285,12558405,0.00019228571679720118,-22438,0.0,24509600,172.48585051818253,0,14,24509586,0,2024-07-26 00:00:00.000 UTC
6227.5,0.0,54861736,15095,7285041,47576695,-10886,89763435.71428572,12566881,0.0001921746219410433,-8476,0.0,24509600,172.50254322522,0,14,24509586,0,2024-07-27 00:00:00.000 UTC
2929.0,0.0,54874350,12614,7278502,47595848,-19153,90037114.28571428,12605196,0.00019234727145778075,-38315,0.0,24509600,173.18393262789513,0,14,24509586,0,2024-07-28 00:00:00.000 UTC
2367.125,0.0,54901149,26799,7289734,47611415,-15567,90151585.71428572,12621222,0.00019205090336629567,-16026,0.0,24509600,173.13693476332608,0,14,24509586,0,2024-07-29 00:00:00.000 UTC
-90.375,0.0,54910987,9838,7292896,47618091,-6676,90193235.71428572,12627053,0.00019196763535363732,-5831,0.0,24509600,173.14182184964656,0,14,24509586,0,2024-07-30 00:00:00.000 UTC
-215.5,0.0,54951884,40897,7288864,47663020,-44929,90709107.14285715,12699275,0.00019207382659355423,-72222,0.0,24509600,174.22845315813274,0,14,24509586,0,2024-07-31 00:00:00.000 UTC
-4038.375,0.0,54972955,21071,7260811,47712144,-49124,90793521.42857143,12711093,0.00019281592648534717,-11818,0.0,24509600,175.06436953117222,0,14,24509586,0,2024-08-01 00:00:00.000 UTC
-4365.75,0.0,55015299,42344,7245104,47770195,-58051,91130500.0,12758270,0.00019323394115529604,-47177,0.0,24509600,176.09505674452706,0,14,24509586,0,2024-08-02 00:00:00.000 UTC
-5435.5,0.0,55026187,10888,7237348,47788839,-18644,91164714.28571428,12763060,0.00019344102287191384,-4790,0.0,24509600,176.3499558125435,0,14,24509586,0,2024-08-03 00:00:00.000 UTC
-5749.0,0.0,55045422,19235,7239049,47806373,-17534,91315050.0,12784107,0.0001933955689483522,-21047,0.0,24509600,176.59926048297228,0,14,24509586,0,2024-08-04 00:00:00.000 UTC
-5422.5,0.0,55353540,308118,7235122,48118418,-312045,91631035.71428572,12828345,0.0001935005380697105,-44238,0.0,24509600,177.30654714599146,0,14,24509586,0,2024-08-05 00:00:00.000 UTC
-4236.5,0.0,55380208,26668,7255842,48124366,-5948,91669571.42857143,12833740,0.00019294797213059492,-5395,0.0,24509600,176.8745791322358,0,14,24509586,0,2024-08-06 00:00:00.000 UTC
-5361.375,0.0,55415542,35334,7250005,48165537,-41171,91733164.28571428,12842643,0.00019310331510116198,-8903,0.0,24509600,177.13978128290947,0,14,24509586,0,2024-08-07 00:00:00.000 UTC
-725.125,0.0,55465828,50286,7283063,48182765,-17228,91763635.71428572,12846909,0.0001922268144597953,-4266,0.0,24509600,176.39431376606245,0,14,24509586,0,2024-08-08 00:00:00.000 UTC
5342.0,0.0,55497765,31937,7303547,48194218,-11453,91836364.28571428,12857091,0.00019168768271088008,-10182,0.0,24509600,176.03899858520796,0,14,24509586,0,2024-08-09 00:00:00.000 UTC
7393.375,0.0,55510997,13232,7304251,48206746,-12528,91850450.0,12859063,0.00019166920742455317,-1972,0.0,24509600,176.0490295308855,0,14,24509586,0,2024-08-10 00:00:00.000 UTC
7979.25,0.0,55529876,18879,7301182,48228694,-21948,91996207.14285715,12879469,0.00019174977421464087,-20406,0.0,24509600,176.40251948246188,0,14,24509586,0,2024-08-11 00:00:00.000 UTC
21140.875,0.0,55748209,218333,7408176,48340033,-111339,92233650.0,12912711,0.00018898039139458888,-33242,0.0,24509600,174.30351276751523,0,14,24509586,0,2024-08-12 00:00:00.000 UTC
21713.625,0.0,55783356,35147,7408831,48374525,-34492,92262842.85714285,12916798,0.0001889636840143877,-4087,0.0,24509600,174.3432668392625,0,14,24509586,0,2024-08-13 00:00:00.000 UTC
14949.75,0.0,55809969,26613,7375440,48434529,-60004,92520157.14285715,12952822,0.0001898191836690421,-36024,0.0,24509600,175.6210070178864,0,14,24509586,0,2024-08-14 00:00:00.000 UTC
11135.375,0.0,55824575,14606,7339088,48485487,-50958,92572742.85714285,12960184,0.00019075939680788677,-7362,0.0,24509600,176.5912058828018,0,14,24509586,0,2024-08-15 00:00:00.000 UTC
5967.75,0.0,55833220,8645,7330805,48502415,-16928,92615271.42857143,12966138,0.0001909749338578778,-5954,0.0,24509600,176.87195335300828,0,14,24509586,0,2024-08-16 00:00:00.000 UTC
2360.625,0.0,55840025,6805,7322432,48517593,-15178,92641892.85714285,12969865,0.00019119330845271079,-3727,0.0,24509600,177.125099966787,0,14,24509586,0,2024-08-17 00:00:00.000 UTC
2205.875,0.0,55847001,6976,7321898,48525103,-7510,92658078.57142857,12972131,0.0001912072525457197,-2266,0.0,24509600,177.16896629808284,0,14,24509586,0,2024-08-18 00:00:00.000 UTC
